Año,Trimestre,Adsl,Cablemodem,Fibra Optica,Wireless,Otros,Total,Año-Trimestre,Id_Provincia
2024,2,214055,2722466,1849476,138638,64745,4989380,20242,2
2024,2,54102,1144781,230402,4493,29821,1463599,20242,1
2024,2,4951,10303,58355,1384,81,75074,20242,3
2024,2,9448,57935,68944,8407,2358,147092,20242,4
2024,2,25955,80704,26516,31118,9930,174223,20242,5
2024,2,93483,443091,477504,62162,9534,1085774,20242,6
2024,2,14849,86226,39792,10295,5313,156475,20242,7
2024,2,31335,158918,68540,23954,11564,294311,20242,8
2024,2,8488,18768,18977,16430,287,62950,20242,9
2024,2,9509,51361,53492,4106,1216,119684,20242,10
2024,2,6778,58647,37226,19510,1102,123263,20242,11
2024,2,2230,55531,23294,6396,30,87481,20242,12
2024,2,17671,66636,188815,27606,925,301653,20242,13
2024,2,20868,76427,87389,14968,6902,206554,20242,14
2024,2,23553,72698,41784,24549,958,163542,20242,15
2024,2,20771,49722,67636,18083,15829,172041,20242,16
2024,2,19831,98511,64689,11807,6503,201341,20242,17
2024,2,12669,16978,45792,23594,6957,105990,20242,18
2024,2,4038,40063,34255,78954,299,157609,20242,19
2024,2,7768,14134,49545,11353,661,83461,20242,20
2024,2,88486,394939,390090,44286,13172,930973,20242,21
2024,2,5328,80000,30008,7058,2920,125314,20242,22
2024,2,9357,47859,3684,177,332,61409,20242,23
2024,2,27968,20806,213753,3869,518,266914,20242,24
2024,1,70108,1177475,203756,4493,48879,1504711,20241,1
2024,1,5901,11025,56542,1384,81,74933,20241,3
2024,1,11343,58929,64463,8404,12404,155543,20241,4
2024,1,26306,77217,26356,30867,9930,170676,20241,5
2024,1,102812,449784,458985,61121,9497,1082199,20241,6
2024,1,18390,85595,38268,10409,5232,157894,20241,7
2024,1,36574,158283,66180,23950,11565,296552,20241,8
2024,1,9147,18631,17908,16851,181,62718,20241,9
2024,1,10554,51093,51084,4106,1216,118053,20241,10
2024,1,6844,59008,35556,19681,1106,122195,20241,11
2024,1,2827,55443,23086,6396,30,87782,20241,12
2024,1,17674,70932,185460,27606,925,302597,20241,13
2024,1,23217,77561,81498,13378,6902,202556,20241,14
2024,1,24076,73298,41577,24387,908,164246,20241,15
2024,1,20841,49727,66889,17733,15829,171019,20241,16
2024,1,23858,99150,61543,11807,6503,202861,20241,17
2024,1,12669,18543,44904,23594,6956,106666,20241,18
2024,1,4038,41260,31539,78954,299,156090,20241,19
2024,1,7768,14435,49545,7799,661,80208,20241,20
2024,1,86548,399817,374288,44162,13773,918588,20241,21
2024,1,6644,80722,27018,7058,2920,124362,20241,22
2024,1,9357,48005,3684,177,332,61555,20241,23
2024,1,33682,20361,205959,4075,518,264595,20241,24
2023,4,223391,2797700,1784593,137993,67943,5011620,20234,2
2023,4,58700,1198835,182520,4492,29820,1474367,20234,1
2023,4,6669,11016,55437,1384,81,74587,20234,3
2023,4,14000,60277,62301,8404,2404,147386,20234,4
2023,4,26306,77217,26174,30543,9930,170170,20234,5
2023,4,115662,452380,440536,61862,8862,1079302,20234,6
2023,4,21769,86102,35968,10402,5231,159472,20234,7
2023,4,41794,159575,61667,24036,11565,298637,20234,8
2023,4,10252,18325,16179,17061,185,62002,20234,9
2023,4,11669,51083,49947,4105,1216,118020,20234,10
2023,4,6844,59063,34331,19982,1106,121326,20234,11
2023,4,3296,55441,22559,6395,30,87721,20234,12
2023,4,17676,70920,182220,27609,926,299351,20234,13
2023,4,25840,79000,75382,12928,7183,200333,20234,14
2023,4,24122,73784,41583,24390,748,164627,20234,15
2023,4,21192,49789,64323,17284,15829,168417,20234,16
2023,4,26765,98853,60800,11806,6508,204732,20234,17
2023,4,12669,18543,42691,22351,6956,103210,20234,18
2023,4,4037,41260,30135,78954,299,154685,20234,19
2023,4,7768,15669,55246,7687,661,87031,20234,20
2023,4,97004,398670,355762,44521,13544,909501,20234,21
2023,4,8290,80692,24271,7057,2920,123230,20234,22
2023,4,9357,48071,3682,157,332,61599,20234,23
2023,4,41318,20267,199876,4357,517,266335,20234,24
2023,3,237705,2784175,1740239,137921,68197,4968237,20233,2
2023,3,60765,1205339,167428,4629,29823,1467984,20233,1
2023,3,7164,11066,54650,1384,91,74355,20233,3
2023,3,16420,60058,54993,8267,2408,142146,20233,4
2023,3,26352,75460,25827,30521,9908,168068,20233,5
2023,3,125050,453994,417338,62514,10438,1069334,20233,6
2023,3,24253,83897,36032,10407,5240,159829,20233,7
2023,3,45384,157464,54794,24481,11170,293293,20233,8
2023,3,11230,18053,14904,16899,228,61314,20233,9
2023,3,12627,51082,48350,4067,1251,117377,20233,10
2023,3,6844,59063,32891,20014,1109,119921,20233,11
2023,3,3726,55494,22054,6395,32,87701,20233,12
2023,3,17677,73066,178719,27609,951,298022,20233,13
2023,3,27934,79087,70003,12928,7183,197135,20233,14
2023,3,24527,73329,39243,24085,3089,164273,20233,15
2023,3,22422,50429,56668,16864,17102,163485,20233,16
2023,3,29113,98324,59914,12337,6545,206233,20233,17
2023,3,12669,19376,42383,22317,6985,103730,20233,18
2023,3,4037,41624,24525,78431,299,148916,20233,19
2023,3,8376,23931,11270,3660,750,47987,20233,20
2023,3,108503,397854,336013,44545,13437,900352,20233,21
2023,3,9412,80919,21745,6916,2936,121928,20233,22
2023,3,9357,45203,3682,157,332,58731,20233,23
2023,3,46348,20545,195053,4088,523,266557,20233,24
2023,2,265537,2766463,1645945,138405,69138,4885488,20232,2
2023,2,68348,1218631,136295,4504,29900,1457678,20232,1
2023,2,7637,10700,53177,1384,92,72990,20232,3
2023,2,19115,59944,51955,8267,2574,141855,20232,4
2023,2,33702,73689,16111,30521,9938,163961,20232,5
2023,2,129303,453924,411703,62391,10430,1067751,20232,6
2023,2,26821,82977,32834,10407,5255,158294,20232,7
2023,2,46503,142562,49251,24461,11170,273947,20232,8
2023,2,11934,17678,13698,16813,227,60350,20232,9
2023,2,13749,51082,47289,4067,1255,117442,20232,10
2023,2,7254,59101,31449,19993,1113,118910,20232,11
2023,2,4152,55148,21245,6395,32,86972,20232,12
2023,2,25299,71931,171857,27609,980,297676,20232,13
2023,2,28897,82058,64406,12927,7183,195471,20232,14
2023,2,26379,73040,35171,24046,3110,161746,20232,15
2023,2,26390,49684,53325,16864,17116,163379,20232,16
2023,2,30666,97501,58275,12337,6549,205328,20232,17
2023,2,21483,20200,25217,23545,7004,97449,20232,18
2023,2,4937,41949,15595,77960,307,140748,20232,19
2023,2,9019,23896,11269,3660,758,48602,20232,20
2023,2,126344,399669,311166,44134,14501,895814,20232,21
2023,2,10629,80086,17244,6916,2934,117809,20232,22
2023,2,12392,45224,525,157,337,58635,20232,23
2023,2,50019,20012,188986,4060,525,263602,20232,24
2023,1,304583,2761043,1551074,132458,71770,4820928,20231,2
2023,1,132149,1223930,156222,4605,31823,1548729,20231,1
2023,1,6980,10655,50230,1384,2243,71492,20231,3
2023,1,21243,60727,49756,8142,2574,142442,20231,4
2023,1,45448,73525,9815,30521,10744,170053,20231,5
2023,1,136976,455139,386297,61066,10494,1049972,20231,6
2023,1,29577,81116,30016,11071,5240,157020,20231,7
2023,1,51084,141699,44508,26415,11172,274878,20231,8
2023,1,12502,17421,13345,17490,227,60985,20231,9
2023,1,15306,51082,46271,4067,1255,117981,20231,10
2023,1,7049,59944,28126,20103,1282,116504,20231,11
2023,1,4652,54604,20722,6395,32,86405,20231,12
2023,1,37646,73678,152534,27592,1569,293019,20231,13
2023,1,30455,82834,56619,12896,7881,190685,20231,14
2023,1,28030,72639,32296,23937,3510,160412,20231,15
2023,1,33604,49128,45329,16857,19413,164331,20231,16
2023,1,33427,96922,56259,12269,6549,205426,20231,17
2023,1,38568,21215,12798,21912,7274,101767,20231,18
2023,1,6283,42789,6952,78954,485,135463,20231,19
2023,1,9702,23839,12217,3660,943,50361,20231,20
2023,1,138935,405618,283988,43487,14246,886274,20231,21
2023,1,11642,80407,16656,6916,2934,118555,20231,22
2023,1,12754,43146,405,157,651,57113,20231,23
2023,1,55822,19482,180976,4293,527,261100,20231,24
2022,4,325908,2767247,1499149,129910,72451,4794665,20224,2
2022,4,138753,1238196,138548,4603,31826,1551926,20224,1
2022,4,8952,10998,47337,1379,2243,70909,20224,3
2022,4,24582,61265,47285,7957,2574,143663,20224,4
2022,4,45450,73923,9815,30721,8850,168759,20224,5
2022,4,152265,456947,367393,61631,11424,1049660,20224,6
2022,4,34038,80283,26752,9082,5298,155453,20224,7
2022,4,55507,135746,40798,26414,12509,270974,20224,8
2022,4,13735,17068,13118,17692,227,61840,20224,9
2022,4,17880,52390,42626,4067,1255,118218,20224,10
2022,4,7785,60566,24552,19995,1266,114164,20224,11
2022,4,6120,54387,19328,6395,32,86262,20224,12
2022,4,37655,77814,147080,27607,1948,292104,20224,13
2022,4,33204,87202,46885,11075,7903,186269,20224,14
2022,4,28609,72679,31567,23815,3510,160180,20224,15
2022,4,34043,48401,43958,16277,19413,162092,20224,16
2022,4,36939,97023,53470,11884,6544,205860,20224,17
2022,4,38570,22913,12491,21912,7940,103826,20224,18
2022,4,6283,43460,3409,81557,511,135220,20224,19
2022,4,9702,23876,12217,3746,662,50203,20224,20
2022,4,163621,412157,248558,44113,19242,887691,20224,21
2022,4,13577,80955,15117,6911,2934,119494,20224,22
2022,4,12754,41293,405,157,651,55260,20224,23
2022,4,69441,20668,168717,4069,527,263422,20224,24
2022,3,339648,2748325,1436433,126846,70416,4721668,20223,2
2022,3,140791,1240125,129218,5758,31787,1547679,20223,1
2022,3,10010,10495,46224,1329,2235,70293,20223,3
2022,3,27164,61800,44645,8178,2359,144146,20223,4
2022,3,45377,72212,9574,29784,8831,165778,20223,5
2022,3,163770,465461,338570,61070,9797,1038668,20223,6
2022,3,36508,77140,18619,7256,5323,144846,20223,7
2022,3,60345,132952,36971,26098,12593,268959,20223,8
2022,3,14470,25880,11041,16935,212,68538,20223,9
2022,3,19257,52978,40172,4033,2383,118823,20223,10
2022,3,7796,60078,23551,20216,4451,116092,20223,11
2022,3,6842,53899,19697,6395,31,86864,20223,12
2022,3,37659,78858,142615,27625,2766,289523,20223,13
2022,3,35513,88902,39046,11074,7622,182157,20223,14
2022,3,29352,75815,29396,27482,1116,163161,20223,15
2022,3,35552,48260,41017,16760,18969,160558,20223,16
2022,3,40006,96984,50254,10082,7215,204541,20223,17
2022,3,38570,22723,12328,21860,7918,103399,20223,18
2022,3,6860,29363,248,70614,14985,122070,20223,19
2022,3,10170,24047,10815,3896,582,49510,20223,20
2022,3,183740,426255,215189,43079,19547,887810,20223,21
2022,3,15385,80937,13170,6618,2922,119032,20223,22
2022,3,12754,39963,403,125,651,53896,20223,23
2022,3,77738,18518,162345,3997,519,263117,20223,24
2022,2,350652,2719613,1399043,126847,71028,4667183,20222,2
2022,2,145491,1232226,121506,5757,31791,1536771,20222,1
2022,2,11928,9430,42087,1329,2234,67008,20222,3
2022,2,29552,61284,42194,8178,2356,143564,20222,4
2022,2,45377,69242,9574,29784,8828,162805,20222,5
2022,2,179181,467595,308895,61107,9657,1026435,20222,6
2022,2,38468,75769,18181,7256,5323,144997,20222,7
2022,2,63794,131029,35839,26098,12592,269352,20222,8
2022,2,15397,25487,9875,16910,212,67881,20222,9
2022,2,20303,54495,34184,3955,2377,115314,20222,10
2022,2,7796,59273,22994,20200,1264,111527,20222,11
2022,2,7759,52656,19189,6395,31,86030,20222,12
2022,2,37663,77504,135504,26964,1927,279562,20222,13
2022,2,37208,89260,33649,11074,7622,178813,20222,14
2022,2,29749,74905,28824,27371,1119,161968,20222,15
2022,2,36050,47040,40946,16760,18968,159764,20222,16
2022,2,42665,96178,47076,10068,7190,203177,20222,17
2022,2,38570,19734,12328,21859,7916,100407,20222,18
2022,2,6860,29034,248,70614,14985,121741,20222,19
2022,2,10170,23725,10815,3896,579,49185,20222,20
2022,2,198492,428233,189503,43081,19550,878859,20222,21
2022,2,16561,80338,11605,6618,2922,118044,20222,22
2022,2,12754,39837,403,125,651,53770,20222,23
2022,2,85893,15327,148823,3997,487,254527,20222,24
2022,1,392045,2728865,1242121,125521,66872,4555424,20221,2
2022,1,102290,1217225,62308,5784,29934,1417541,20221,1
2022,1,14181,15517,29118,1328,2234,62378,20221,3
2022,1,32391,64546,36662,8164,2356,144119,20221,4
2022,1,44133,66667,9184,30592,21052,171628,20221,5
2022,1,195610,501799,235838,60843,9713,1003803,20221,6
2022,1,40462,79093,10875,6774,5374,142578,20221,7
2022,1,67159,138986,23091,26098,12592,267926,20221,8
2022,1,16397,15927,5146,16876,202,54548,20221,9
2022,1,21307,60616,25949,4662,3975,116509,20221,10
2022,1,8003,58978,21739,19903,1109,109732,20221,11
2022,1,9103,59228,9546,6395,31,84303,20221,12
2022,1,49464,74145,123228,26969,1379,275185,20221,13
2022,1,39147,91752,25178,7807,7624,171508,20221,14
2022,1,28443,73200,24193,23098,745,149679,20221,15
2022,1,38662,45366,38037,16815,18494,157374,20221,16
2022,1,44714,98667,40994,5950,7190,197515,20221,17
2022,1,34038,14449,11294,20723,7674,88178,20221,18
2022,1,7987,11296,31,71809,28721,119844,20221,19
2022,1,10537,23420,10766,3974,405,49102,20221,20
2022,1,213486,444609,146552,45261,20571,870479,20221,21
2022,1,18118,87979,1093,6349,2922,116461,20221,22
2022,1,13031,38700,416,124,340,52611,20221,23
2022,1,92532,62396,86174,3995,487,245584,20221,24
2021,4,426325,2706506,1176024,126887,73415,4509157,20214,2
2021,4,111360,1205128,60005,5679,29947,1412119,20214,1
2021,4,16385,13858,25100,1512,2235,59090,20214,3
2021,4,35548,63145,34688,8005,2359,143745,20214,4
2021,4,46361,57412,9655,28041,18839,160308,20214,5
2021,4,212011,487489,217214,61277,8779,986770,20214,6
2021,4,42523,71183,10138,6778,5290,135912,20214,7
2021,4,70459,133387,23452,25022,12726,265046,20214,8
2021,4,17211,15111,5151,16018,172,53663,20214,9
2021,4,22330,60511,24156,2927,3991,113915,20214,10
2021,4,8175,58000,20192,19286,1354,107007,20214,11
2021,4,10387,56651,9446,6613,31,83128,20214,12
2021,4,59842,71553,109667,24666,1859,267587,20214,13
2021,4,41778,92068,22035,7649,7602,171132,20214,14
2021,4,29175,72761,23253,21531,746,147466,20214,15
2021,4,42037,44495,32212,16558,18451,153753,20214,16
2021,4,46972,99808,39555,5882,7188,199405,20214,17
2021,4,35868,13102,11072,11423,8493,79958,20214,18
2021,4,8472,11064,30,70560,28723,118849,20214,19
2021,4,10790,22902,10031,4346,417,48486,20214,20
2021,4,233427,444373,128856,43556,16229,866441,20214,21
2021,4,19032,86563,1088,6256,2922,115861,20214,22
2021,4,13317,38148,426,124,342,52357,20214,23
2021,4,97830,59022,78790,2511,486,238639,20214,24
2021,3,585729,2595485,885613,120228,64554,4251609,20213,2
2021,3,142902,1192107,42966,6059,29371,1413405,20213,1
2021,3,18413,11709,22331,1568,2233,56254,20213,3
2021,3,38258,63659,27583,8018,2353,139871,20213,4
2021,3,49269,55794,8946,23376,18681,156066,20213,5
2021,3,229275,477223,167495,57617,15178,946788,20213,6
2021,3,44805,69403,7542,6766,5303,133819,20213,7
2021,3,74443,128752,20485,23500,13195,260375,20213,8
2021,3,18093,14111,4730,15690,171,52795,20213,9
2021,3,23554,60758,19926,2952,3968,111158,20213,10
2021,3,9015,57881,17817,14479,1295,100487,20213,11
2021,3,11329,54744,9444,6613,30,82160,20213,12
2021,3,91474,71247,70579,21811,828,255939,20213,13
2021,3,43230,89469,10969,7198,7662,158528,20213,14
2021,3,29650,73794,16455,19270,640,139809,20213,15
2021,3,47934,44519,18725,15031,18376,144585,20213,16
2021,3,49212,98318,36126,5724,6453,195833,20213,17
2021,3,40072,12922,6670,11372,8447,79483,20213,18
2021,3,8417,11884,27,68856,28680,117864,20213,19
2021,3,12347,22961,6328,4269,3071,48976,20213,20
2021,3,245929,443156,93412,43447,15640,841584,20213,21
2021,3,19939,85535,909,6147,2928,115458,20213,22
2021,3,12853,36958,6,16,390,50223,20213,23
2021,3,104489,53868,70964,2408,743,232472,20213,24
2021,2,603255,2503830,854173,113546,57547,4132351,20212,2
2021,2,148989,1175097,41318,5580,29371,1400355,20212,1
2021,2,20305,9426,22331,1449,2233,55744,20212,3
2021,2,39826,62948,27584,8018,2353,140729,20212,4
2021,2,49271,41497,6081,23682,18706,139237,20212,5
2021,2,239780,467782,151855,55944,15519,930880,20212,6
2021,2,46648,67262,3731,6557,5303,129501,20212,7
2021,2,77836,124957,17856,23786,13197,257632,20212,8
2021,2,19571,12509,3610,15690,171,51551,20212,9
2021,2,24738,60800,19611,2731,3968,111848,20212,10
2021,2,9017,57014,17132,13209,1295,97667,20212,11
2021,2,11627,54255,9445,6245,30,81602,20212,12
2021,2,91503,70834,44696,21811,827,229671,20212,13
2021,2,44960,87861,10376,5317,7662,156176,20212,14
2021,2,30083,72690,15619,19218,640,138250,20212,15
2021,2,48189,43761,18727,15031,18376,144084,20212,16
2021,2,51396,96016,32050,5724,6453,191639,20212,17
2021,2,40072,12369,6673,11372,8447,78933,20212,18
2021,2,8417,11308,28,66860,36205,122818,20212,19
2021,2,12347,22967,6328,4269,3071,48982,20212,20
2021,2,256741,431915,90424,43997,17523,840600,20212,21
2021,2,20734,83770,909,5081,3596,114090,20212,22
2021,2,12853,22504,6,14,316,35693,20212,23
2021,2,110429,48359,71683,1837,743,233051,20212,24
2021,1,629679,2452056,821597,98806,57864,4060002,20211,2
2021,1,159805,1145093,39980,5559,29236,1379673,20211,1
2021,1,26316,4409,18688,322,2233,51968,20211,3
2021,1,43214,61251,25426,8004,1875,139770,20211,4
2021,1,45501,40960,3444,23723,18712,132340,20211,5
2021,1,260350,444695,134634,54137,17065,910881,20211,6
2021,1,49160,62876,3337,5949,5303,126625,20211,7
2021,1,83688,118424,16846,20836,12169,251963,20211,8
2021,1,20663,11412,2562,15669,380,50686,20211,9
2021,1,32254,54324,17322,2677,3879,110456,20211,10
2021,1,8946,58711,15779,12369,1300,97105,20211,11
2021,1,17363,34984,1,250,30,52628,20211,12
2021,1,91844,69295,38619,18332,833,218923,20211,13
2021,1,48292,82339,7064,4796,6896,149387,20211,14
2021,1,30223,70457,14171,17752,632,133235,20211,15
2021,1,48777,42192,17828,13994,18377,141168,20211,16
2021,1,54768,89187,31498,5669,6452,187574,20211,17
2021,1,40072,11589,6671,11482,8453,78267,20211,18
2021,1,8417,10678,28,63826,36205,119154,20211,19
2021,1,12347,23089,5975,4264,390,46065,20211,20
2021,1,277012,421480,70976,39140,17519,826127,20211,21
2021,1,26468,75849,570,5158,3596,111641,20211,22
2021,1,12853,27247,6,0,316,40422,20211,23
2021,1,147199,12185,69954,1834,740,231912,20211,24
2020,4,635651,2441248,804991,93444,57927,4033261,20204,2
2020,4,163060,1142528,39890,4815,29237,1379530,20204,1
2020,4,26870,5115,17856,322,2233,52396,20204,3
2020,4,44332,61200,23687,7997,1875,139091,20204,4
2020,4,45703,39756,3040,23363,18712,130574,20204,5
2020,4,267396,439322,125620,52827,17536,902701,20204,6
2020,4,50102,61495,3146,5626,5290,125659,20204,7
2020,4,85683,113670,15653,20206,12169,247381,20204,8
2020,4,21264,10789,2432,15341,380,50206,20204,9
2020,4,32850,52815,15639,1077,3470,105851,20204,10
2020,4,9009,58945,15432,12194,1315,96895,20204,11
2020,4,17513,34984,1,250,30,52778,20204,12
2020,4,91842,68364,36083,18331,833,215453,20204,13
2020,4,49462,79855,6589,4359,6896,147161,20204,14
2020,4,30468,70614,13732,17689,632,133135,20204,15
2020,4,48991,42022,17826,13994,18377,141210,20204,16
2020,4,56659,87817,30604,5858,6452,187390,20204,17
2020,4,40072,7004,6599,10468,8453,72596,20204,18
2020,4,8417,11767,27,63019,36205,119435,20204,19
2020,4,12347,19657,1041,4659,2970,40674,20204,20
2020,4,287271,414746,62692,38712,17392,820813,20204,21
2020,4,26812,70522,570,5169,3596,106669,20204,22
2020,4,12853,26439,6,0,316,39614,20204,23
2020,4,149322,11150,68043,1834,740,231089,20204,24
2020,3,653930,2384557,749087,94162,55541,3937277,20203,2
2020,3,170375,1129573,39417,3936,29374,1372675,20203,1
2020,3,26868,3690,16857,261,2228,49904,20203,3
2020,3,45745,58825,20675,6706,2003,133954,20203,4
2020,3,45761,39386,2897,23216,18767,130027,20203,5
2020,3,276360,430771,102217,48368,9756,867472,20203,6
2020,3,50858,58681,2960,5513,5379,123391,20203,7
2020,3,87892,106950,13954,20379,12320,241495,20203,8
2020,3,21790,10003,2000,15023,393,49209,20203,9
2020,3,32611,57682,11112,952,4371,106728,20203,10
2020,3,9015,56845,14677,11893,1305,93735,20203,11
2020,3,17346,34984,1,250,35,52616,20203,12
2020,3,91908,64672,32817,17523,868,207788,20203,13
2020,3,50195,77989,2572,3445,8985,143186,20203,14
2020,3,30222,70446,11043,16787,737,129235,20203,15
2020,3,49530,40001,10381,13187,18368,131467,20203,16
2020,3,58216,84128,25445,5764,7293,180846,20203,17
2020,3,40092,9223,5509,14023,8480,77327,20203,18
2020,3,8401,10077,6,61828,36253,116565,20203,19
2020,3,12845,16098,1027,6938,2373,39281,20203,20
2020,3,295051,405807,45721,37112,19307,802998,20203,21
2020,3,26419,70720,555,4185,3613,105492,20203,22
2020,3,12854,26491,0,0,310,39655,20203,23
2020,3,149605,11752,59949,1808,762,223876,20203,24
2020,2,661272,2244277,723072,91736,57189,3777546,20202,2
2020,2,178896,1106133,39482,3937,29373,1357821,20202,1
2020,2,26968,3641,14878,261,2228,47976,20202,3
2020,2,46816,56017,17266,6452,1581,128132,20202,4
2020,2,45761,38279,1324,17678,5614,108656,20202,5
2020,2,282858,415007,85818,44522,8263,836468,20202,6
2020,2,51248,55536,3144,3927,5011,118866,20202,7
2020,2,89391,99423,13954,20042,11303,234113,20202,8
2020,2,21805,9353,1882,14723,169,47932,20202,9
2020,2,32705,38938,5057,952,16664,94316,20202,10
2020,2,8551,54422,14232,11314,1290,89809,20202,11
2020,2,16885,34984,1,250,35,52155,20202,12
2020,2,91904,62941,29613,15924,802,201184,20202,13
2020,2,50792,74497,2579,3319,9153,140340,20202,14
2020,2,30256,67990,11037,15755,1134,126172,20202,15
2020,2,49756,39650,10382,11331,18367,129486,20202,16
2020,2,59502,81740,24289,5123,7108,177762,20202,17
2020,2,40092,8275,5509,7019,8882,69777,20202,18
2020,2,8401,8357,6,60935,36253,113952,20202,19
2020,2,12845,16044,1027,6585,2368,38869,20202,20
2020,2,299974,381679,46698,30487,19094,777932,20202,21
2020,2,25917,72074,355,3038,4063,105447,20202,22
2020,2,12854,26025,0,0,310,39189,20202,23
2020,2,150084,9833,55120,1357,762,217156,20202,24
2020,1,673237,2210349,720688,85443,18334,3708051,20201,2
2020,1,184494,1097635,38898,3911,28556,1353494,20201,1
2020,1,21945,3146,12056,261,2227,39635,20201,3
2020,1,46356,54144,11958,6239,1580,120277,20201,4
2020,1,45763,27287,1324,16885,5479,96738,20201,5
2020,1,286168,406109,68512,41617,8693,811099,20201,6
2020,1,51126,53231,2172,2437,5004,113970,20201,7
2020,1,90368,95434,13245,18737,14062,231846,20201,8
2020,1,21068,8887,1800,14510,169,46434,20201,9
2020,1,32066,38938,3078,942,16641,91665,20201,10
2020,1,8553,53755,13821,11295,1802,89226,20201,11
2020,1,13076,34984,0,251,29,48340,20201,12
2020,1,91955,50251,28059,12465,722,183452,20201,13
2020,1,51458,69452,1220,460,10962,133552,20201,14
2020,1,29305,65951,11031,14711,729,121727,20201,15
2020,1,47756,38479,10381,11222,18362,126200,20201,16
2020,1,60426,75593,23025,4125,7212,170381,20201,17
2020,1,40092,6448,5508,7082,5101,64231,20201,18
2020,1,8301,7612,5,58301,36333,110552,20201,19
2020,1,12845,15766,1026,6817,2368,38822,20201,20
2020,1,302366,383673,35123,30488,19468,771118,20201,21
2020,1,24695,70424,200,2779,4657,102755,20201,22
2020,1,12854,25632,0,0,308,38794,20201,23
2020,1,143184,10494,44687,1355,347,200067,20201,24
2019,4,720011,2191672,669194,87111,18266,3686254,20194,2
2019,4,196938,1093143,35534,3914,28576,1358105,20194,1
2019,4,22999,3318,9506,261,2227,38311,20194,3
2019,4,48661,53602,8831,5229,1580,117903,20194,4
2019,4,47045,26977,1324,15267,5489,96102,20194,5
2019,4,296872,410038,53335,37750,8693,806688,20194,6
2019,4,52525,51845,2002,2458,5004,113834,20194,7
2019,4,92981,99206,12875,18561,15407,239030,20194,8
2019,4,21567,8684,1760,14531,169,46711,20194,9
2019,4,32949,37604,873,814,16641,88881,20194,10
2019,4,15457,56854,4942,11341,1805,90399,20194,11
2019,4,13738,34984,0,251,29,49002,20194,12
2019,4,96678,49711,24989,13672,730,185780,20194,13
2019,4,53116,69676,847,441,11733,135813,20194,14
2019,4,29826,60970,10549,14246,854,116445,20194,15
2019,4,49747,37933,9658,11437,18365,127140,20194,16
2019,4,63272,76062,21865,3040,8206,172445,20194,17
2019,4,41360,6338,4931,7241,5104,64974,20194,18
2019,4,8569,8027,6,55266,36333,108201,20194,19
2019,4,13264,15899,1036,6800,2371,39370,20194,20
2019,4,312072,382254,27464,26978,20401,769169,20194,21
2019,4,24682,71239,200,2810,4657,103588,20194,22
2019,4,13261,26821,0,0,310,40392,20194,23
2019,4,146985,11012,39574,725,348,198644,20194,24
2019,3,1277249,2144956,425386,85572,27070,3960233,20193,2
2019,3,300288,1080973,24900,3895,31155,1441211,20193,1
2019,3,24349,5543,13,244,2251,32400,20193,3
2019,3,50416,49156,8063,5224,1592,114451,20193,4
2019,3,37298,27090,1917,15149,7551,89005,20193,5
2019,3,307780,399231,30064,37277,8701,783053,20193,6
2019,3,53344,50230,1888,2458,4839,112759,20193,7
2019,3,94947,96305,12888,18530,15432,238102,20193,8
2019,3,21777,8359,1476,14292,162,46066,20193,9
2019,3,33110,35742,274,812,16638,86576,20193,10
2019,3,19469,52941,4994,11462,1962,90828,20193,11
2019,3,14390,34984,11,251,41,49677,20193,12
2019,3,148640,54312,6865,12975,1545,224337,20193,13
2019,3,54493,65872,829,419,12270,133883,20193,14
2019,3,43347,60484,5560,13512,2518,125421,20193,15
2019,3,67478,37425,9739,10806,18847,144295,20193,16
2019,3,65799,74329,733,1580,9394,151835,20193,17
2019,3,51670,7425,1227,7241,5535,73098,20193,18
2019,3,13037,10561,350,62286,36466,122700,20193,19
2019,3,10663,17056,969,6544,2738,37970,20193,20
2019,3,319396,377171,18690,24269,21408,760934,20193,21
2019,3,24556,71198,219,2759,34400,133132,20193,22
2019,3,19790,26659,651,0,1487,48587,20193,23
2019,3,150918,12089,116,684,324,164131,20193,24
2019,2,1284658,2079900,382971,75240,32929,3855698,20192,2
2019,2,309937,1061358,36082,3962,4281,1415620,20192,1
2019,2,25682,5543,13,146,2251,33635,20192,3
2019,2,50765,47448,4203,4727,1591,108734,20192,4
2019,2,37313,26338,1917,14443,7545,87556,20192,5
2019,2,314768,388254,23023,33847,15236,775128,20192,6
2019,2,53835,47431,1701,2444,6138,111549,20192,7
2019,2,97081,91081,12764,17369,17529,235824,20192,8
2019,2,21916,8686,1382,14292,162,46438,20192,9
2019,2,33022,30742,274,812,21857,86707,20192,10
2019,2,19471,52101,4840,10789,3004,90205,20192,11
2019,2,15014,34984,11,251,41,50301,20192,12
2019,2,148673,54027,6865,12748,1544,223857,20192,13
2019,2,55373,64272,543,421,12269,132878,20192,14
2019,2,43420,59021,4983,12792,2737,122953,20192,15
2019,2,67841,36527,4037,10485,19657,138547,20192,16
2019,2,68827,62343,725,1210,9463,142568,20192,17
2019,2,51680,7425,1174,2870,6876,70025,20192,18
2019,2,11130,10298,347,57242,38368,117385,20192,19
2019,2,10665,10257,379,6514,2735,30550,20192,20
2019,2,325420,355140,18236,21980,22708,743484,20192,21
2019,2,24393,64783,219,2759,34600,126754,20192,22
2019,2,19790,25527,651,0,1486,47454,20192,23
2019,2,153121,12089,116,684,321,166331,20192,24
2019,1,1304507,2020730,336362,64867,20201,3746667,20191,2
2019,1,328246,1030814,32281,3978,4281,1399600,20191,1
2019,1,26912,4443,16,0,2251,33622,20191,3
2019,1,53409,43555,1951,3628,1134,103677,20191,4
2019,1,37302,23065,1923,14443,3045,79778,20191,5
2019,1,323272,363959,19902,24615,12367,744115,20191,6
2019,1,55842,43444,1615,1528,58,102487,20191,7
2019,1,100999,90253,12723,16231,12241,232447,20191,8
2019,1,22570,7878,940,13761,62,45211,20191,9
2019,1,33248,12484,153,640,43622,90147,20191,10
2019,1,18832,57373,2891,9023,1041,89160,20191,11
2019,1,16367,34984,12,252,41,51656,20191,12
2019,1,148524,40205,5662,10363,1544,206298,20191,13
2019,1,54898,59214,465,426,7717,122720,20191,14
2019,1,40747,55634,3114,12510,2372,114377,20191,15
2019,1,68377,34124,3994,9736,4857,121088,20191,16
2019,1,74426,57933,647,1135,1879,136020,20191,17
2019,1,51660,5838,808,2932,1207,62445,20191,18
2019,1,11108,7784,378,53097,23968,96335,20191,19
2019,1,10659,4615,382,6514,2735,24905,20191,20
2019,1,340038,340344,15621,23215,17860,737078,20191,21
2019,1,25337,61547,23,2847,99,89853,20191,22
2019,1,19789,23549,1623,0,1486,46447,20191,23
2019,1,159215,11670,118,678,321,172002,20191,24
2018,4,1305576,1949637,296102,65477,19814,3636606,20184,2
2018,4,328253,1019490,33042,3978,4257,1389020,20184,1
2018,4,26912,4443,16,0,2212,33583,20184,3
2018,4,53409,43555,1940,3236,1130,103270,20184,4
2018,4,37215,23065,952,14443,3047,78722,20184,5
2018,4,328854,355716,17675,21851,13243,737339,20184,6
2018,4,55842,42418,796,1515,30,100601,20184,7
2018,4,101168,86198,4853,15472,14356,222047,20184,8
2018,4,22619,7880,887,13761,57,45204,20184,9
2018,4,33248,12484,153,640,43608,90133,20184,10
2018,4,18832,55337,2685,7772,1010,85636,20184,11
2018,4,16367,34984,12,252,36,51651,20184,12
2018,4,148524,40205,5665,10363,1547,206304,20184,13
2018,4,55500,53673,465,426,6209,116273,20184,14
2018,4,40747,55634,3115,12425,2444,114365,20184,15
2018,4,68377,34292,1299,8037,4832,116837,20184,16
2018,4,74295,57539,638,253,1853,134578,20184,17
2018,4,51660,5838,806,2883,1211,62398,20184,18
2018,4,11108,7784,378,53097,23964,96331,20184,19
2018,4,10659,4615,382,6378,2734,24768,20184,20
2018,4,335519,322782,14387,18705,28997,720390,20184,21
2018,4,25339,61243,23,2649,81,89335,20184,22
2018,4,19789,23349,1623,0,1499,46260,20184,23
2018,4,159215,11670,119,686,314,172004,20184,24
2018,3,1435856,1929273,156382,62318,26448,3610277,20183,2
2018,3,334353,1009252,35694,3872,9319,1392490,20183,1
2018,3,27553,4443,15,1,2214,34226,20183,3
2018,3,53927,42359,1990,2628,1129,102033,20183,4
2018,3,58887,23065,1239,13817,6728,103736,20183,5
2018,3,337620,342401,15785,19213,10839,725858,20183,6
2018,3,56444,41300,212,1468,32,99456,20183,7
2018,3,103318,83714,2403,15093,80,204608,20183,8
2018,3,22777,7589,817,13625,57,44865,20183,9
2018,3,33363,10856,32,641,43,44935,20183,10
2018,3,12415,54574,8437,7011,987,83424,20183,11
2018,3,16587,34984,13,253,35,51872,20183,12
2018,3,151033,40205,5744,8195,1852,207029,20183,13
2018,3,56290,50793,512,391,56,108042,20183,14
2018,3,46602,54129,998,12277,2712,116718,20183,15
2018,3,68590,33474,1252,5051,5125,113492,20183,16
2018,3,76600,53980,678,234,1391,132883,20183,17
2018,3,54025,5838,826,2744,1048,64481,20183,18
2018,3,11096,7784,368,52859,2314,74421,20183,19
2018,3,18606,4574,585,6238,3996,33999,20183,20
2018,3,339126,312866,11749,16337,15022,695100,20183,21
2018,3,25805,58789,23,1662,81,86360,20183,22
2018,3,19365,22649,1502,1,2047,45564,20183,23
2018,3,161209,9280,110,252,315,171166,20183,24
2018,2,1450203,1807868,143626,71256,27746,3500699,20182,2
2018,2,342431,977916,35610,3908,9321,1369186,20182,1
2018,2,27444,4415,15,1,2214,34089,20182,3
2018,2,54134,40750,562,1946,1129,98521,20182,4
2018,2,58935,19591,1239,14070,6729,100564,20182,5
2018,2,345141,327636,13832,16355,10109,713073,20182,6
2018,2,56541,39715,201,1468,32,97957,20182,7
2018,2,104811,80376,2405,12313,80,199985,20182,8
2018,2,23543,7311,18,13625,57,44554,20182,9
2018,2,33571,10856,23,640,43,45133,20182,10
2018,2,12416,53587,8420,7011,987,82421,20182,11
2018,2,16663,34984,13,253,35,51948,20182,12
2018,2,152938,36872,3084,6206,1852,200952,20182,13
2018,2,57265,47923,512,391,56,106147,20182,14
2018,2,46633,52855,998,12649,2713,115848,20182,15
2018,2,68667,32795,1252,4396,5125,112235,20182,16
2018,2,78386,53478,678,234,1391,134167,20182,17
2018,2,54080,5068,826,3079,1048,64101,20182,18
2018,2,11104,7666,368,16,2314,21468,20182,19
2018,2,18615,4474,585,6734,3997,34405,20182,20
2018,2,337934,304349,11354,15801,15114,684552,20182,21
2018,2,26074,55935,23,1662,81,83775,20182,22
2018,2,19372,22756,531,1,2047,44707,20182,23
2018,2,160315,8965,110,252,315,169957,20182,24
2018,1,1452061,1793884,133928,64379,31194,3475446,20181,2
2018,1,349995,968483,35535,3164,9393,1366570,20181,1
2018,1,27300,4415,15,1,2214,33945,20181,3
2018,1,54879,40157,383,388,1130,96937,20181,4
2018,1,56375,19591,1194,14070,6729,97959,20181,5
2018,1,349342,326894,13178,13237,11275,713926,20181,6
2018,1,56937,35225,888,1334,33,94417,20181,7
2018,1,106998,75751,3789,10776,80,197394,20181,8
2018,1,23556,7095,17,1603,57,32328,20181,9
2018,1,33856,10456,23,28,43,44406,20181,10
2018,1,10807,51389,8386,10556,1926,83064,20181,11
2018,1,16960,34984,13,253,35,52245,20181,12
2018,1,152931,36872,3086,6206,1852,200947,20181,13
2018,1,56311,46880,328,5,56,103580,20181,14
2018,1,46714,55072,1000,12404,2713,117903,20181,15
2018,1,68769,31712,1251,4259,5128,111119,20181,16
2018,1,79936,51534,118,204,1391,133183,20181,17
2018,1,54080,5068,826,2246,1048,63268,20181,18
2018,1,11104,7594,368,16,2314,21396,20181,19
2018,1,18615,4474,1799,6734,2783,34405,20181,20
2018,1,341997,300421,10674,11636,15298,680026,20181,21
2018,1,26788,54594,23,1432,81,82918,20181,22
2018,1,19372,9663,531,1,2047,31614,20181,23
2018,1,158611,8921,107,368,50,168057,20181,24
2017,4,1241172,1718013,131181,60082,31448,3181896,20174,2
2017,4,571363,961688,36277,3119,9877,1582324,20174,1
2017,4,27083,263,11,1,2200,29558,20174,3
2017,4,55035,39690,389,380,1121,96615,20174,4
2017,4,56378,15097,1187,14070,6708,93440,20174,5
2017,4,349710,324709,12778,12043,10739,709979,20174,6
2017,4,56786,34722,894,1334,35,93771,20174,7
2017,4,107764,73692,1894,10267,86,193703,20174,8
2017,4,23410,6973,19,1603,51,32056,20174,9
2017,4,33844,9626,20,28,34,43552,20174,10
2017,4,10808,50495,8272,10569,1927,82071,20174,11
2017,4,16912,34984,14,253,31,52194,20174,12
2017,4,152896,16114,3015,6206,1920,180151,20174,13
2017,4,56271,47470,95,5,54,103895,20174,14
2017,4,46739,54119,1017,12404,2692,116971,20174,15
2017,4,68690,30451,1250,4259,5114,109764,20174,16
2017,4,80705,50446,127,158,1376,132812,20174,17
2017,4,54079,451,812,2246,1036,58624,20174,18
2017,4,11104,1119,335,17,2329,14904,20174,19
2017,4,18614,1668,582,4638,3950,29452,20174,20
2017,4,341680,293831,10602,10965,15382,672460,20174,21
2017,4,27313,40407,19,1025,80,68844,20174,22
2017,4,19372,6906,530,1,2045,28854,20174,23
2017,4,156583,5223,105,102,319,162332,20174,24
2017,3,1288025,1571180,124920,35058,38777,3057960,20173,2
2017,3,583249,941092,33481,2814,9723,1570359,20173,1
2017,3,26873,4411,12,1,2181,33478,20173,3
2017,3,54888,37307,456,36,1072,93759,20173,4
2017,3,56359,5645,1217,13503,6820,83544,20173,5
2017,3,344580,319360,10579,7137,14988,696644,20173,6
2017,3,56247,33993,947,1334,27,92548,20173,7
2017,3,107774,69596,1786,6245,63,185464,20173,8
2017,3,22647,6816,428,2202,12,32105,20173,9
2017,3,33796,9395,20,23,8,43242,20173,10
2017,3,11378,49679,5153,11536,1944,79690,20173,11
2017,3,16638,34984,14,252,25,51913,20173,12
2017,3,154036,33788,2772,29,1866,192491,20173,13
2017,3,56472,43880,110,5,9,100476,20173,14
2017,3,48001,52468,1044,11576,2695,115784,20173,15
2017,3,69301,30018,1106,3054,4017,107496,20173,16
2017,3,80782,50284,127,158,1167,132518,20173,17
2017,3,54499,5068,816,1053,1013,62449,20173,18
2017,3,11407,7576,347,26,2363,21719,20173,19
2017,3,19220,5487,1544,4552,2887,33690,20173,20
2017,3,322953,290655,6338,4897,37499,662342,20173,21
2017,3,27733,54096,19,911,35,82794,20173,22
2017,3,21587,7012,622,1,2244,31466,20173,23
2017,3,154130,6431,106,40,305,161012,20173,24
2017,2,1378549,1535037,119132,21555,24358,3078631,20172,2
2017,2,615262,932466,38628,2819,11016,1600191,20172,1
2017,2,26401,255,14,1,34,26705,20172,3
2017,2,54449,35613,458,52,39,90611,20172,4
2017,2,43994,1067,916,13194,4804,63975,20172,5
2017,2,341748,303488,4451,6446,1505,657638,20172,6
2017,2,55262,33192,258,1354,31,90097,20172,7
2017,2,108309,67650,254,6448,71,182732,20172,8
2017,2,22493,6410,17,1023,13,29956,20172,9
2017,2,33742,8858,22,0,35,42657,20172,10
2017,2,12754,48310,5194,6253,511,73022,20172,11
2017,2,16244,0,15,2,28,16289,20172,12
2017,2,153331,13030,2581,27,1784,170753,20172,13
2017,2,56752,42925,103,5,9,99794,20172,14
2017,2,51794,50283,1133,11545,2678,117433,20172,15
2017,2,67038,29147,961,3213,1260,101619,20172,16
2017,2,80184,27280,115,158,804,108541,20172,17
2017,2,48670,451,772,1073,915,51881,20172,18
2017,2,11432,1120,354,26,375,13307,20172,19
2017,2,15311,2722,1365,4735,2255,26388,20172,20
2017,2,329813,228102,3234,4958,1173,567280,20172,21
2017,2,28337,3900,19,911,29,33196,20172,22
2017,2,22636,6905,665,1,2350,32557,20172,23
2017,2,149013,5223,116,14,45,154411,20172,24
2017,1,1559178,1465817,118839,21200,24342,3189376,20171,2
2017,1,428801,918328,38259,2730,10928,1399046,20171,1
2017,1,26020,248,14,1,34,26317,20171,3
2017,1,54430,34277,252,52,39,89050,20171,4
2017,1,43994,999,916,13194,4793,63896,20171,5
2017,1,335673,293479,4871,5782,1394,641199,20171,6
2017,1,54993,31994,236,1354,31,88608,20171,7
2017,1,108509,65095,230,6448,71,180353,20171,8
2017,1,22438,6215,16,1023,13,29705,20171,9
2017,1,33869,9278,22,0,34,43203,20171,10
2017,1,12754,47195,5194,6253,517,71913,20171,11
2017,1,16180,0,15,2,28,16225,20171,12
2017,1,153326,13030,2581,27,1769,170733,20171,13
2017,1,57363,40142,101,5,8,97619,20171,14
2017,1,51771,48109,1124,11665,2670,115339,20171,15
2017,1,67075,28785,954,3213,1261,101288,20171,16
2017,1,79837,26845,114,158,679,107633,20171,17
2017,1,48670,451,772,1073,907,51873,20171,18
2017,1,11432,1120,354,26,375,13307,20171,19
2017,1,15502,2722,1272,4733,2257,26486,20171,20
2017,1,327458,226094,3210,4948,1172,562882,20171,21
2017,1,29616,3900,19,911,29,34475,20171,22
2017,1,22636,6905,665,1,2350,32557,20171,23
2017,1,147373,5223,116,14,45,152771,20171,24
2016,4,1563542,1414676,118747,21394,24342,3142701,20164,2
2016,4,434835,914952,38161,2583,10928,1401459,20164,1
2016,4,26735,250,14,1,34,27034,20164,3
2016,4,54974,33534,248,52,39,88847,20164,4
2016,4,43994,955,916,13107,4793,63765,20164,5
2016,4,337368,289344,3368,5686,789,636555,20164,6
2016,4,54981,31497,233,1354,31,88096,20164,7
2016,4,109359,64141,226,6448,71,180245,20164,8
2016,4,22400,6061,16,1023,13,29513,20164,9
2016,4,33838,8731,22,0,34,42625,20164,10
2016,4,12754,47245,5054,6253,522,71828,20164,11
2016,4,16270,0,16,2,28,16316,20164,12
2016,4,153320,13030,2579,27,1769,170725,20164,13
2016,4,57983,39294,100,5,8,97390,20164,14
2016,4,51742,46389,1124,11910,2670,113835,20164,15
2016,4,67057,28474,954,3274,1261,101020,20164,16
2016,4,79389,26657,110,158,621,106935,20164,17
2016,4,48670,451,772,1121,907,51921,20164,18
2016,4,11432,1120,354,26,375,13307,20164,19
2016,4,15607,2722,1055,4823,2257,26464,20164,20
2016,4,326721,225792,3201,4946,1172,561832,20164,21
2016,4,30192,3900,19,911,29,35051,20164,22
2016,4,22636,6905,665,1,2350,32557,20164,23
2016,4,146995,4482,116,14,45,151652,20164,24
2016,3,1574216,1355770,113463,18867,24276,3086592,20163,2
2016,3,447726,905105,36796,2514,10963,1403104,20163,1
2016,3,26689,248,14,1,18,26970,20163,3
2016,3,56251,32730,232,2,15,89230,20163,4
2016,3,43987,935,916,13364,4750,63952,20163,5
2016,3,348481,285480,2540,5695,395,642591,20163,6
2016,3,55934,30813,217,1354,22,88340,20163,7
2016,3,112588,61850,206,6441,64,181149,20163,8
2016,3,21800,5905,9,0,2,27716,20163,9
2016,3,34250,8236,22,0,30,42538,20163,10
2016,3,12751,45952,4910,6236,515,70364,20163,11
2016,3,16891,0,15,2,22,16930,20163,12
2016,3,153233,13030,2576,28,1757,170624,20163,13
2016,3,59776,38130,79,5,7,97997,20163,14
2016,3,51752,44739,1093,12402,2617,112603,20163,15
2016,3,67043,28496,942,3293,1252,101026,20163,16
2016,3,80866,26113,90,157,565,107791,20163,17
2016,3,48670,451,770,1174,903,51968,20163,18
2016,3,11432,1113,354,23,371,13293,20163,19
2016,3,15570,2722,817,4978,2170,26257,20163,20
2016,3,334911,223011,3037,4862,1190,567011,20163,21
2016,3,31730,3900,19,3,8,35660,20163,22
2016,3,22636,6276,665,1,2347,31925,20163,23
2016,3,147259,3850,116,53,41,151319,20163,24
2016,2,1579448,1305949,113070,21163,25661,3045291,20162,2
2016,2,450644,892209,36669,2390,12672,1394584,20162,1
2016,2,26262,245,14,1,34,26556,20162,3
2016,2,56112,31825,221,52,41,88251,20162,4
2016,2,43977,867,916,13293,4803,63856,20162,5
2016,2,348891,277615,1709,5610,1089,634914,20162,6
2016,2,55511,29845,203,1354,43,86956,20162,7
2016,2,112809,58768,169,6434,193,178373,20162,8
2016,2,22101,5658,6,1023,14,28802,20162,9
2016,2,33758,7374,22,0,35,41189,20162,10
2016,2,12754,44654,4708,6225,547,68888,20162,11
2016,2,16691,0,15,2,28,16736,20162,12
2016,2,153321,13030,2576,29,1868,170824,20162,13
2016,2,59573,36145,77,5,15,95815,20162,14
2016,2,51742,42370,1088,12466,2849,110515,20162,15
2016,2,67031,28100,939,3300,1334,100704,20162,16
2016,2,79438,24719,85,151,539,104932,20162,17
2016,2,48670,451,770,1214,908,52013,20162,18
2016,2,11432,1063,354,30,377,13256,20162,19
2016,2,15453,2722,396,4996,2586,26153,20162,20
2016,2,336244,219088,2981,4744,1417,564474,20162,21
2016,2,32101,3900,19,911,30,36961,20162,22
2016,2,22636,5707,665,1,2350,31359,20162,23
2016,2,145486,2968,116,58,49,148677,20162,24
2016,1,1583560,1200859,111231,21108,25757,2942515,20161,2
2016,1,454425,832126,36332,2284,12729,1337896,20161,1
2016,1,26096,243,15,1,34,26389,20161,3
2016,1,56353,29994,211,52,41,86651,20161,4
2016,1,43967,834,916,13280,4803,63800,20161,5
2016,1,350884,252346,674,5636,386,609926,20161,6
2016,1,55454,28491,192,1354,45,85536,20161,7
2016,1,113101,54948,146,6425,193,174813,20161,8
2016,1,21852,5420,5,1023,14,28314,20161,9
2016,1,33481,6751,22,0,35,40289,20161,10
2016,1,12754,41881,4536,6209,549,65929,20161,11
2016,1,16645,0,16,2,28,16691,20161,12
2016,1,153299,13030,2576,34,1871,170810,20161,13
2016,1,59538,33330,70,5,15,92958,20161,14
2016,1,51702,36122,1085,12502,2850,104261,20161,15
2016,1,66894,27312,937,3341,1338,99822,20161,16
2016,1,78973,22741,73,132,507,102426,20161,17
2016,1,48670,451,770,1195,908,51994,20161,18
2016,1,11432,1042,354,27,377,13232,20161,19
2016,1,15654,2723,396,5088,2426,26287,20161,20
2016,1,338052,204816,3014,4686,1428,551996,20161,21
2016,1,32838,3900,19,911,30,37698,20161,22
2016,1,22636,4834,665,1,2350,30486,20161,23
2016,1,144233,2165,116,74,49,146637,20161,24
2015,4,1586343,1223603,103269,20397,25773,2959385,20154,2
2015,4,455427,879950,19818,2273,12758,1370226,20154,1
2015,4,26180,242,15,1,34,26472,20154,3
2015,4,56818,29456,186,52,41,86553,20154,4
2015,4,43968,811,916,13521,4803,64019,20154,5
2015,4,353530,266062,480,5613,385,626070,20154,6
2015,4,55681,28178,177,1354,45,85435,20154,7
2015,4,113983,53411,122,6427,194,174137,20154,8
2015,4,21734,5314,4,1023,14,28089,20154,9
2015,4,32934,6933,22,0,35,39924,20154,10
2015,4,12755,42705,4327,6205,374,66366,20154,11
2015,4,16886,0,16,2,28,16932,20154,12
2015,4,153293,13030,2572,38,1874,170807,20154,13
2015,4,60252,32533,48,5,15,92853,20154,14
2015,4,51680,38902,1048,12934,2852,107416,20154,15
2015,4,66851,27221,915,3407,1328,99722,20154,16
2015,4,78744,22446,47,129,554,101920,20154,17
2015,4,48670,451,770,1230,908,52029,20154,18
2015,4,11432,1025,354,30,377,13218,20154,19
2015,4,15614,2723,396,5261,2409,26403,20154,20
2015,4,339843,212911,2885,4596,1437,561672,20154,21
2015,4,33582,4365,19,1139,30,39135,20154,22
2015,4,22636,4301,665,1,2350,29953,20154,23
2015,4,144188,1653,116,88,50,146095,20154,24
2015,3,1585467,1183894,113590,19989,25825,2928765,20153,2
2015,3,454815,871262,30974,2229,12788,1372068,20153,1
2015,3,25801,242,15,1,34,26093,20153,3
2015,3,56282,28809,186,52,41,85370,20153,4
2015,3,43964,792,916,13408,4803,63883,20153,5
2015,3,351692,264055,1450,5412,389,622998,20153,6
2015,3,55792,27604,176,1340,47,84959,20153,7
2015,3,113909,51945,122,6261,197,172434,20153,8
2015,3,21573,5264,2,899,14,27752,20153,9
2015,3,32598,6895,22,0,35,39550,20153,10
2015,3,12755,41886,4078,6195,557,65471,20153,11
2015,3,16725,0,16,2,28,16771,20153,12
2015,3,153299,13030,2572,42,1880,170823,20153,13
2015,3,59921,31635,46,5,15,91622,20153,14
2015,3,47102,36620,1045,13051,2798,100616,20153,15
2015,3,66806,27130,917,3415,1346,99614,20153,16
2015,3,78064,21688,47,129,645,100573,20153,17
2015,3,48670,451,770,1231,908,52030,20153,18
2015,3,11432,1025,354,31,377,13219,20153,19
2015,3,15540,2718,396,5226,2391,26271,20153,20
2015,3,337042,209673,4169,4426,1428,556738,20153,21
2015,3,33886,4365,19,1097,30,39397,20153,22
2015,3,22636,8085,665,1,2350,33737,20153,23
2015,3,142925,1135,116,88,50,144314,20153,24
2015,2,1581770,1141052,115660,19268,26040,2883790,20152,2
2015,2,453178,858342,19786,2172,12806,1346284,20152,1
2015,2,25387,242,15,1,34,25679,20152,3
2015,2,55767,27809,179,52,41,83848,20152,4
2015,2,43949,762,916,13055,4803,63485,20152,5
2015,2,348130,255596,435,5199,386,609746,20152,6
2015,2,55238,26553,157,1321,47,83316,20152,7
2015,2,113378,49767,119,6031,197,169492,20152,8
2015,2,21097,5164,2,737,50,27050,20152,9
2015,2,32183,5482,22,0,35,37722,20152,10
2015,2,12756,40825,3719,6190,562,64052,20152,11
2015,2,16463,0,16,2,28,16509,20152,12
2015,2,153301,13030,2572,38,1882,170823,20152,13
2015,2,59179,29283,37,5,15,88519,20152,14
2015,2,47078,34183,1044,12781,2799,97885,20152,15
2015,2,66738,26268,916,3457,1348,98727,20152,16
2015,2,77214,20297,47,129,580,98267,20152,17
2015,2,48670,451,770,1189,908,51988,20152,18
2015,2,11432,1025,354,33,377,13221,20152,19
2015,2,15343,2707,396,4917,2400,25763,20152,20
2015,2,333117,204685,2877,4320,1389,546388,20152,21
2015,2,33873,4365,19,1091,30,39378,20152,22
2015,2,22636,7927,665,1,2350,33579,20152,23
2015,2,139944,479,116,88,50,140677,20152,24
2015,1,1583135,1096836,134177,18754,28940,2861842,20151,2
2015,1,454934,841743,19334,1994,14716,1332721,20151,1
2015,1,25033,241,16,1,41,25332,20151,3
2015,1,54952,26161,164,27,56,81360,20151,4
2015,1,45645,717,906,12540,5465,65273,20151,5
2015,1,343883,247564,415,4645,450,596957,20151,6
2015,1,54649,25372,129,1319,62,81531,20151,7
2015,1,112363,47411,108,5943,245,166070,20151,8
2015,1,21022,4951,1,670,56,26700,20151,9
2015,1,31505,5048,22,0,36,36611,20151,10
2015,1,13143,39571,3215,6164,604,62697,20151,11
2015,1,16282,0,16,2,33,16333,20151,12
2015,1,152433,13030,2542,29,2126,170160,20151,13
2015,1,58262,26836,30,5,13,85146,20151,14
2015,1,47518,32152,1024,12088,2960,95742,20151,15
2015,1,66274,25217,907,3473,1462,97333,20151,16
2015,1,76280,19781,47,129,574,96811,20151,17
2015,1,48441,451,755,1165,1007,51819,20151,18
2015,1,11414,1025,351,30,412,13232,20151,19
2015,1,16215,2700,392,4772,2562,26641,20151,20
2015,1,328809,199037,2845,4239,1507,536437,20151,21
2015,1,33813,4365,19,1020,35,39252,20151,22
2015,1,22291,7924,657,1,2583,33456,20151,23
2015,1,137857,115,116,88,100,138276,20151,24
2014,4,1575978,1070135,120528,17728,32038,2816407,20144,2
2014,4,455785,840224,17155,1962,15394,1330520,20144,1
2014,4,25192,241,16,0,44,25493,20144,3
2014,4,55024,10918,31,0,62,66035,20144,4
2014,4,48539,697,891,12256,6159,68542,20144,5
2014,4,345157,240452,419,3918,486,590432,20144,6
2014,4,54754,9526,40,1315,75,65710,20144,7
2014,4,112291,23027,57,5178,260,140813,20144,8
2014,4,21245,4896,1,0,65,26207,20144,9
2014,4,31349,4583,22,37,11,36002,20144,10
2014,4,16043,34281,514,5894,648,57380,20144,11
2014,4,16352,0,17,0,33,16402,20144,12
2014,4,151797,13030,2534,31,2222,169614,20144,13
2014,4,58435,18613,16,150,15,77229,20144,14
2014,4,47721,31778,1014,11853,3030,95396,20144,15
2014,4,66307,23703,901,3819,1530,96260,20144,16
2014,4,76026,17289,48,6,578,93947,20144,17
2014,4,48653,451,740,1202,1073,52119,20144,18
2014,4,11419,926,355,24,423,13147,20144,19
2014,4,17553,448,388,4395,2929,25713,20144,20
2014,4,335267,183009,3205,6282,1634,529397,20144,21
2014,4,34110,4231,19,920,37,39317,20144,22
2014,4,21948,3664,655,1,2722,28990,20144,23
2014,4,137093,97,116,13,105,137424,20144,24
2014,3,1562533,1110628,124474,20049,31881,2849565,20143,2
2014,3,450155,833402,17886,1995,14387,1317825,20143,1
2014,3,24380,244,15,0,47,24686,20143,3
2014,3,53321,10336,29,1,59,63746,20143,4
2014,3,49219,668,882,11853,6515,69137,20143,5
2014,3,340212,240334,444,4064,377,585431,20143,6
2014,3,52957,9184,31,1312,65,63549,20143,7
2014,3,108907,22440,48,5203,135,136733,20143,8
2014,3,21021,4836,0,0,80,25937,20143,9
2014,3,30128,3541,22,37,13,33741,20143,10
2014,3,16051,33940,538,11219,677,62425,20143,11
2014,3,15864,0,14,1,37,15916,20143,12
2014,3,150120,13030,2512,40,2222,167924,20143,13
2014,3,56933,18373,4,3,14,75327,20143,14
2014,3,54458,30964,1000,12858,3087,102367,20143,15
2014,3,65264,26590,888,3533,1505,97780,20143,16
2014,3,73828,18394,43,109,580,92954,20143,17
2014,3,48272,451,731,1199,1126,51779,20143,18
2014,3,11303,925,355,25,438,13046,20143,19
2014,3,17862,492,385,4273,3098,26110,20143,20
2014,3,325577,183630,4407,6540,733,520887,20143,21
2014,3,32820,3900,19,768,41,37548,20143,22
2014,3,21840,3469,650,1,2832,28792,20143,23
2014,3,131739,97,117,13,100,132066,20143,24
2014,2,1568881,1025490,120008,17020,33147,2764546,20142,2
2014,2,447637,828411,17729,1883,14555,1310215,20142,1
2014,2,24380,243,17,0,43,24683,20142,3
2014,2,53321,9870,30,0,58,63279,20142,4
2014,2,51070,649,866,10960,6974,70519,20142,5
2014,2,337825,234729,351,3673,374,576952,20142,6
2014,2,52883,8680,31,1309,55,62958,20142,7
2014,2,108900,21706,49,4795,133,135583,20142,8
2014,2,20894,4628,0,0,78,25600,20142,9
2014,2,30128,4161,23,40,9,34361,20142,10
2014,2,15957,32600,513,5869,689,55628,20142,11
2014,2,15864,0,14,0,34,15912,20142,12
2014,2,148979,13030,2480,36,2282,166807,20142,13
2014,2,56933,17594,4,150,8,74689,20142,14
2014,2,47767,29776,997,10765,2983,92288,20142,15
2014,2,64920,24944,876,3657,1560,95957,20142,16
2014,2,73841,17504,45,7,577,91974,20142,17
2014,2,48161,451,722,1139,1173,51646,20142,18
2014,2,11306,925,354,22,448,13055,20142,19
2014,2,18956,448,381,4118,3266,27169,20142,20
2014,2,324101,178495,3085,6041,636,512358,20142,21
2014,2,32820,4231,19,907,34,38011,20142,22
2014,2,21618,3008,648,1,2934,28209,20142,23
2014,2,131740,97,121,13,98,132069,20142,24
2014,1,1567685,1000879,120960,16528,33824,2739876,20141,2
2014,1,445569,820161,17767,1866,14555,1299918,20141,1
2014,1,24126,46,17,0,43,24232,20141,3
2014,1,52971,9497,30,0,58,62556,20141,4
2014,1,51066,539,866,10776,6974,70221,20141,5
2014,1,336841,225769,347,3585,368,566910,20141,6
2014,1,52565,8279,31,1306,55,62236,20141,7
2014,1,107883,21379,49,4887,133,134331,20141,8
2014,1,20774,4548,0,0,100,25422,20141,9
2014,1,29765,4030,23,0,9,33827,20141,10
2014,1,15826,31305,513,5848,701,54193,20141,11
2014,1,15663,0,14,0,34,15711,20141,12
2014,1,148970,12076,2480,37,2282,165845,20141,13
2014,1,56597,17191,4,150,8,73950,20141,14
2014,1,47790,28161,997,10381,3051,90380,20141,15
2014,1,64886,24156,876,3576,1572,95066,20141,16
2014,1,73131,17538,45,8,568,91290,20141,17
2014,1,48161,434,722,808,1173,51298,20141,18
2014,1,11306,428,354,21,448,12557,20141,19
2014,1,18927,100,381,4092,3264,26764,20141,20
2014,1,322662,174296,3059,5951,644,506612,20141,21
2014,1,32567,3598,19,915,34,37133,20141,22
2014,1,21618,2837,648,1,2934,28038,20141,23
2014,1,129717,83,121,13,98,130032,20141,24
